111111111
1001000P1
1C000E001
111111111