111111111
10P000C01
1C000E001
111111111