11111111111111111111111111111111111111111111111111111111111111111111111111111111111
10P0000000000C000001111111111111111111100000000000000000000000000000000000000000001
10P000C000000C000001C0000000000E001000000000000000000000000000000000000000000000001
10000E00C0000001000C000000C00000010001100000000000000000000000000000000000000000001
10P00000000000000001C000E0000000001000000000000000000000000000000000000000000000001
11111111100000010001000000001CC0000000000000000000000000000000000000000000000000001
1111111110000C0000010000E00C0000001000000000000000000000000000000000000000000000001
11111111100000010001111111100000000000000000000000000000000000000000000000000000001
10P0000000000C00000C000000000010000000000000000000000000000000000000000000000000001
100000000000111100000000001E0000000001100000000000000000000000000000000000000000001
10P00000000011110001C000E00C000E001000000000000000000000000000000000000000000000001
10000E00C00011110000000000000CP0000000000000000000000000000000000000000000000000001
10P00000000000000000011111111111110000000000000000000000000000000000000000000000001
10000000000000010000011111111111110000000000000000000000000000000000000000000000001
10P000C000000C0000000CC000000000000000000000000000000000000000000000000000000000001
10000000C000000111111100000000C00C0000000000000000000000000000000000000000000000001
11111111111111111111000000000000000000000000000000000000000000000000000000000000001
1C000000C000E0010000000000000000000000000000000000000000000000000000000000000000001
10P000C000000C0000000C00000C0000000001100000000000000000000000000000000000000000001
1C000E00C00000010000000000000000000000000000000000000000000000000000000000000000001
11111111111111111111111111111111111111111111111111111111111111111111111111111111111