11111111111111111111
10P000C000000C000001
1C000E00C000E0010001
10P000C000000C000001
1C000E00C000E0010001
10P000C000000C000001
1C000E00C000E0010001
10P000C000000C000001
1C000E00C000E0010001
10P000C000000C000001
1C000E00C000E0010001
11111111111111111111