111111111
1000C00P1
1C010E001
111111111